##############################
#B#                          #
# # # # #  ############# #####
#   # # #  #                 #
# #   # #  # ####  # # ## # ##
# ##### #  ######  ### ## #  #
# #   ###  #       # ### #####
# ### # #  #  #####  # #  ####
# #        #               # #
########## # ############### #
#                            #
# ########################## #
#A                         # #
# ########################## #
#                       #    #
##############################