###############################
#A                            #
# # # # #  # ########### ## ###
#   # # #  # #                #
# #   ###  #  ###  # # ## #  ##
# # ### #  ######  ### ## #   #
# #   # #  #       # ### ## ###
##### # #  #  #####  # #  # ###
#          #                # #
########## # ############## # #
#                             #
# ########### ############# # #
#          #     #          # #
# ## ####### ############## # #
# # #     #    #            # #
### # ## ##### ############## #
# #   #                 #     #
# # ############# ##### ##### #
#               #     #  B    #
###############################